%%%%%%%%%%%%%%%%%%%%%%%%%%%%
%...........%....%....%..%.%
%.%%%.%%%%%.%.%%.%.%%%%..%.%
%.%.......%.%..%.%.%.......%
%.%%.%.%%.%%%%.%%%.%%%%%%%.%
%..%.%.%.....%.............%
%%.%.%.%%%%%.%.%%%.%%%%%%..%
%..%.%.%.....%.%.%.%.......%
%.%%.%.%.%%%%%.%.%.%%%%%%%.%
%......%.....%...%.%.......%
%.%%%%.%%%%%.%%%%%.%%.%%%%.%
%....%................%....% 
%%%%.%.%%.%%%%%%%%.%%.%.%%%%
%....%.%%..........%%.%....%
%.%%%%.%%%%%%%%%%%%%%.%%%%.%
%.............P............%
%%%%%%%%%%%%%%%%%%%%%%%%%%%%
