%%%%%%%%%%%%%%%%%%%%%%%%%%%%%%
%.     %% .    %    %        %
% %%%  %%      % % .%%% %%   %
%   %     %%%%%% %  % %  %  .%
%   % .      . % %.      %%%%%
%%%%% %%%%%%   %%%%%%%       %
%.    % .% %  %%     .   %%% %
%        % %  P%   %%%%%%%.  %
% %%%%%% %    %%%% %     % %%%
%.%      %%%       %.      %.%
% %  %%%%%   %%%%  %%%%%%. % %
%       .  %. %     .        %
%%%%%%%%%%%%%%%%%%%%%%%%%%%%%%
